1111111111111111111
10000000000P0000001
1000000000000000001
10000000000000E0001
100C000000000000001
1000000000000000001
1111111111111111111
