11111
100E1
1P001
10C01
11111
